********
***---**
**/xxx\*
**\xxx|*
***\xx/*
****--**
********
********
